###########################################################################################################################
#                                                                                                                         #
#                                                                                                                         #
#                                                                                                                         #
#                                                                                                                         #
#                                                                                                                         #
#                                                                                                                         #
#                                                                                                                         #
#                                                                                                                         #
#                                                                                                                         #
#                                                                                                                         #
#                                                                                                                         #
#                                                                                                                         #
#                                                                                                                         #
#                                                                                                                         #
#                                                                                                                         #
#                                                                                                                         #
#                                                                                                                         #
#                                                                                                                         #
#                ################                #               ################                    #                    #
#                #              #                #               #              #                   # #                   #
#                #              #                #               #              #                  #   #                  #
#                #              #                #               #              #                 #     #                 #
#                #              #                #               #              #                #       #                #
#                #              #                #               #              #               #         #               #
#                #              #                #               #              #              #           #              #
#                #              #                #               #              #             #             #             #
#                #              #                #               #              #                                         #
#                #              #                #                                                                        #
#                #    #    #    #                #                                                                        #
#                #    #    #    #                #                                                                        #
#                ######    ######                #                                                                        #
#                                                                                                                         #
#                                                                                                                         #
#                                                                                                                         #
#                                                                                                                         #
#                                                                                                                         #
#                                                                                                                         #
#                                                                                                                         #
#                                                                                                                         #
#                                                                                                                         #
#                                                                                                                         #
#                                                                                                                         #
#                                                                                                                         #
#                                                                                                                         #
#                                                                                                                         #
#                                                                                                                         #
#                                                                                                                         #
#                                                                                                                         #
#                                                                                                                         #
###########################################################################################################################