##################################################################################################
#                                                                                                #
#                                                                                                #
#                                                                                                #
#                                                                                                #
#                                                                                                #
#                                                                                                #
#                                                                                                #
#                                                                                                #
#                                                                                                #
#                                                                                                #
#                                                                                                #
#                                                                                                #
#                                                                                                #
#                ################                #               ################                #
#                #              #                #               #              #                #
#                #              #                #               #              #                #
#                #              #                #               #              #                #
#                #              #                #               #              #                #
#                #              #                #               #              #                #
#                #              #                #               #              #                #
#                #              #                #               #              #                #
#                #              #                #                                               #
#                #              #                #                                               #
#                #    #    #    #                #                                               #
#                #    #    #    #                #                                               #
#                ######    ######                #                                               #
#                                                                                                #
#                                                                                                #
#                                                                                                #
#                                                                                                #
#                                                                                                #
#                                                                                                #
#                                                                                                #
#                                                                                                #
#                                                                                                #
#                                                                                                #
#                                                                                                #
#                                                                                                #
#                                                                                                #
#                                                                                                #
#                                                                                                #
#                                                                                                #
#                                                                                                #
#                                                                                                #
##################################################################################################