##################################################
#                                                #
#                                                #
#       ##                                       #
#                     #                          #
#                                                #
#                                                #
#                                                #
#                           ###########          #
#                                     #          #
#                                     #          #
#                                     #          #
#                                     #          #
#                                     #          #
#                                     #          #
#                                     #          #
#                                     #          #
#                                     #          #
#                                     #          #
#                                     #          #
#                                     #          #
#                                     #          #
#                                     #          #
#                           ###########          #
#                                                #
#                                                #
#         ###                                    #
#                              #########         #
#                                                #
#                                                #
#                                                #
##################################################